1001111011
111P00000001
100000E11111
100C000001
111111111
