111111111
1000000001
10000000001
100000000001
1000000000001
10000000000001
10000E000000001
10000000000001
1000000000001
100000000001
10000000001
1000000001
1000000P1
11111111
