111111111111111
11000P00000E001
000000000000001
1000000C0000001
100CC0000011111
110000000000001
111111111111111
