11111111111111
11000P00000E01
10000000000001
10000000000001
1000C000000001
11100000011111
11111111011111
