111111111111
11000P00E000
100000000001
100000000001
100000000001
10C000000001
100000000001
100000C00001
100000000001
100000000001
10000C000001
100000000001
111111111111
