111101111111111
11000C00000E001
100000000000001
100000000000001
100000000000001
100000000000001
100000000000001
10000C000000001
1000000000P0001
100000000000001
100C00000000001
100000000000001
111111111111111
