111111111111111
1000000000E0001
100000000000001
100000000000001
1C00000000C0001
100000000000001
100000000000001
111111111111111
