1111111111111111111111
1100000000000000000001
1000000000000P00E00001
1000000000000000000001
1000000000000000000001
1111111111111111111111
