111111111111111
100000100000001
1000P0100000001
100000100000E11
1C0001110000011
100000100000001
100000100000001
111111111111111
