1111111111111111
100000000000E001
1000000000000001
1000000P00000001
1000000000000001
1000000000000001
10000000000E0001
1000000100010001
1111111111111111
