1111111111111111111111
1100000000000000000001
1000000000000P00000001
1000000000000000000001
100000000C000000000001
1111111111111111111111
