1111111
1000001
1P00001
1000001
10000E1
1000P01
1000001
1111111
