11111111111111111111
100000000000E0000001
1000000000000000C001
1000000P000000000001
100S0000000000000001
1000000000000000C001
1000C000010001000001
11111111111111111111
