11111111111111111111111
1C000000000000000000001
101111111111011110111C1
101000001C0001001000111
10001010111011011110001
1111101000111000C011101
1P1C0011100000111010001
1011111011111010101C101
10100000000000101111101
10111011111110000001101
10001010000010111111101
101C1010101010100000101
10001000001C10101110101
10111111101110101C10101
10100000101000100010101
10101110101011111010101
10101010101000000010101
10101010111111111110101
100000100000000000000E1
11111111111111111111111
