111111111111111111
10000000000000C001
1000C000000P000111
100000100000E11111
1C0001110000011111
100000000000001111
1000000000C0000111
111000000000000011
110000C00000000001
1000000000000C0001
1C0000000000000001
111111111111111111
