111111111111111
100000000000001
1000000000P0001
100000100000E11
100001110000011
10000C100000001
100000000000001
111111111111111
