111111111111111111
100000000A0000C001
1000C000000P000101
100000000000E11101
1C0000000000011101
100000000A00001101
1100000000C0000101
111000000000000001
110000C00000000001
1000000000000C1A01
1C1000000000000001
111111111111111111
