111111111111111111111111111111111111111111111111111111111111111111111111
100000000000000000000000000000000000000000000000000000000000000000000001
100000000000000A00000000000000000000000000000000000000000000000000000001
100000000000000000000000000000000000000000000000000000000000000000000001
100000000000000000000000000000000000110000000000000000000000000000000001
1000000000000AAA00000000000000000001001000000000000000000000000000000001
100000000000A000A0000000000000000001001000000000000000000000000000000001
100000000000A0E0A0000000000000000000110000000000000000000001100000000001
100000000000000000000000000000000000000000000000000000000010010000000001
100000000000000000000000000000001000000000000000000000000010010000000001
100000000000000000000000000000000000000000000000000000000001100000000001
100000000000000000000000000000000000000000000000000000000000000000000001
10000000000000C000000000000000000000000000000000000000000000000000000001
100000000000000000000000000000000000000000000000000000000000000000000001
100000000000000000000000000000000000000000000000000000000000000000000001
100000000000000000000000000000000000000000000000000000000000000000000001
10000000000000000000000000000001000000C000000000000000000000000000000001
100000000000000000000000000000000000000000000000000000000000000000000001
100000000000000000000000000000000000000000000000000000000000000000000001
100000000000000000000000000000000000000000000000000000000000000000000001
100000000000000000000000000000000000000000000000000000000000C00000000001
1000000000000000000C0000000000000000000000000000000000000000000000000001
10000000A000000000000000000000000000000C00000000000000000000000000000001
10000000A000000000000000000000000000000000000000000000000000000000000001
1000000AAA00000000000000000000000000000000000000000000000000000000000001
10000AAAAAAA000000000000000000000000000000000000000000000000000000000001
1000000AAA00000000000000000000000000000000000000000000000000000000000001
10000000A000000000000000000000000000000000000000000000000000000000000001
10000000A000000000000000000000000000000000000000P00000000000000000000001
100000000000000000000000000000000000000000000000000000000000000000000001
100000000000000000000000000000000000000000000000000000000000000000000001
100000000000000000000000000000000000000000000000000000000000000000000001
100000000000000000000000000000000000000000000000000000000000000000000001
100000000000000000000000000000000000000000000000000000000000000000000001
1000000000000000000000000000000000000000000000000000000C0000000000000001
100000000000000000000000000000000000000000000000000000000000000000000001
10110000110001111111100000000000000000000000C000000000000000000000000001
101100001100011111111000000000000000000000000000000000000000000000000001
101100001100000000011000000000000000000000000000000000000000000000000001
101100001100000000011000000000000000000000000000000000000000000000000001
101111111100011111111000000000000000000000000000000000000000000000000001
101111111100011111111000000000000000000000000000000000000000000000000001
100000001100011000000000000000000000000000000000000000000000000000000001
100000001100011000000000000000000000000000000000000000000000000000000001
1000000011000111111110000000000000000000000000000000000000000000000A0001
100000001100011111111000000000000000000000000000000000000000000000000001
100000000000000000000000000000000000000000000000000000000000000000000001
111111111111111111111111111111111111111111111111111111111111111111111111
